NO ./texture/wall1.png
SO ./texture/wall2.png
WE ./texture/wall3.png
EA ./texture/wall4.png

F 200,100,0
C 225,30,0

11111
110001
100W01
111111
