NO ./texture/wall1.png
SO ./texture/wall2.png
WE ./texture/wall3.png
EA ./texture/wall4.png

F 220,100,0
C 225,30,0

1 1 1
11111
10001
00S01
11111
