NO ./texture/wall1.png
SO ./texture/wall2.png
WE ./texture/wall3.png
EA ./texture/wall4.png

F 220,100,225
C 100,30,100

 1     1
101111101111
10000000000111
111110010N00001
    101010111111111
    1111111111001001
  11001111111111111
  10001
111001
10001
1011
 1
