NO ./texture/wall1.png
SO ./texture/wall2.png
WE ./texture/wall3.png
EA ./texture/wall4.png

C 53,41,34
F 45,33,27

111111111111111
1100000000011111111111
110000000001000011111111
11000000000000011111111
1100000000000001111111
1100000000011111111111
110000000011111111111
11111100001111111
1100000000000111
11000E000000011
110000000000011
110000000000011
110000000000011
110000000000011
100001111100001
110000111000011
111000010000111
111100000001111
111110000011111
111111000111111
111111111111111

