
NO ./texture/wall1.png








SO ./texture/wall2.png
   WE ./texture/wall3.png
      EA ./texture/wall4.png
          
        F 20,           20,             20
C 200,          200,200


  111111111111111111
 1100000S000000000011
1110000000000000000111
 11000001111100000011
  111111     1111111
