NO ./texture/wall1.png
SO ./texture/wall2.png
WE ./texture/wall3.png
EA ./texture/wall4.png

F 250,100,0
C 250,50,0

111111111
1000N0001
111111111
