NO ./texture/wall1.png
SO ./texture/wall2.png
WE ./texture/wall3.png
EA ./texture/wall4.png

F 200,200,200
C 150,150,150

 11111  11111
10000111100011
100000S00001111
111110010000011
  111010000001111
   11000000100111
  11001111110111111
  10001  111010011
111001    11000011
10001    110011111
1011     11111111
111
